1111111111111111111111111111111111111
10000000000000000000000000000000000C1
1000000000000111111101111111111111101
100000000011111111C001111000111111101
100000001111111PC00001000C00111111101
1000011111111E000000000000001111111C1
1001111111C00000000000000111111110001
10111111C0000000000000011111111000001
10111100000000CC000001111111000000001
1011111111111111111101111111000000101
1011111111111111111101111111000111101
1000000000000111111101111111111111101
100C000000000111111100000000000000001
10000000000C011111110000000C0000000C1
1111111111110000000000000011111111111
1111111111111111111111111111111111111