1111111111111111111111
1000000000000000000001
1000010111111000101001
101001001P0E1010001001
10100100100C1010001001
100000001C001000000001
1000000011111000000001
1000000000000001000001
1111111111111111111111