1111111111111111111111111111111111111
1000000000000000000000000000000000001
1000000000000111111101111111111111101
1000000000111111110001111000111111101
100000001111111P00000100000C111111101
1000011111111E00000000000000111111101
1001111111000000000000000111111110001
1011111100000000000000011111111000001
1011110000000000000001111111000000001
1011111111111111111101111111000000101
1011111111111111111101111111000111101
1000000000000111111101111111111111101
100C000000000111111100000000000000001
10000000000C011111110000000C0000000C1
1111111111110000000000000011111111111
1111111111111111111111111111111111111