11111111111111111111111111111111111111
10000000000000000000000000000000000C01
10000000000001111111011111111111111001
10000G000011111111C0011110001111111001
100000001111111PC00001000C001111111001
1000011111111E000000000000001111111C01
1001111111C000000000000001111111100001
10111111C00000000000000111111110000001
10111100000000CC0000011111110000000001
10111111111111111111011111110000001001
10111111111111111111011111110001111001
10000000000001111111011111111111111001
100C0000000001111111000000000000000001
10000000000C011111110000000C00000000C1
11111111111100000000000000111111111111
11111111111111111111111111111111111111